1 1 5 1 5 1 1 1 5 1 5 1
2 2 3 4 2 2 2 2 2 3 2 2
3 4 2 4 3 3 3 4 3 4 3 1
5 1 1 1 1 1 1 1 5 5 5 3
2 2 3 1 2 2 2 2 3 3 2 2
3 4 2 4 3 4 3 4 2 4 3 2